11111
100C1
1PE01
10101
10001
11111