111111111111111111
1P010000000C0000C1
100001111100CC1101
100011000000CC1001
111111000CC0010001
111111101101111111
111111111101111111
10010000000C0000C1
100001111100CC1101
100011000000CC1001
111111000CC0010001
111111101101111111
111111111101111111
10010000000C0000C1
100001111100CC1101
1000110E0000CC1001
111111111111111111
