11111111111111
10000000100001
1001000E001010
1P00P0000C0001
11111111111111