11111111111111
10000000100001
1001000E0P1011
1P0010000C0001
11111111111111