11111111
1E1CP101
10000101
11111111